12
40
1111111111111111111111111111111111111111
1000000000000000000000000000000000000001
1000006000000000000000000000000000000001
1000000000000000000000000000000000000001
1111111110000000000000000000000000000001
1000000000000000000000000000000000000001
1000000000005000000000000000000000000001
1000000000000000000000000000000000000001
1000000000000000000000000000000000000001
1000000000000000000000111100000000300001
1090000000000000000000000000000000200001
1111111111111144441111111111111111111111